NO      ./textures/blue_wall.png
SO ./textures/brick_wall.png
WE ./textures/green_wall.png
EA ./textures/yellow_wall.png

F 0,    128, 128
C 216,   230,255

        1111111111111111111111111
        1000000000110000000000001
        1011000001110000N00000001
        1001000000000000000000001
111111111011000001110000000000001
100000000011000001110111111111111
11110111111111011100000010001
11110111111111011101010010001
110000001101011 11100000010001
10000000000000011100000010001
10000000000000001101010010001
1100000111010101111101111000111
11110111 1110101 101111010001
11111111 1111111 111111111111